十八禁	十八禁 🔞
a型血	a型血 🅰️
ab型血	ab型血 🆎
b型血	b型血 🅱️
cl按钮	cl按钮 🆑
cool按钮	cool按钮 🆒
dna	dna 🧬
dvd	dvd 📀
id按钮	id按钮 🆔
new按钮	new按钮 🆕
ng按钮	ng按钮 🆖
o型血	o型血 🅾️
ok	ok 👌
ok按钮	ok按钮 🆗
ok手势	ok手势 🙆
on!箭头	on!箭头 🔛
soon箭头	soon箭头 🔜
sos按钮	sos按钮 🆘
t恤	t恤 👕
up按钮	up按钮 🆙
vs按钮	vs按钮 🆚
x射线	x射线 🩻
阿尔巴尼亚	阿尔巴尼亚 🇦🇱
阿尔及利亚	阿尔及利亚 🇩🇿
阿富汗	阿富汗 🇦🇫
阿根廷	阿根廷 🇦🇷
阿拉伯联合酋长国	阿拉伯联合酋长国 🇦🇪
阿鲁巴	阿鲁巴 🇦🇼
阿曼	阿曼 🇴🇲
阿塞拜疆	阿塞拜疆 🇦🇿
阿森松岛	阿森松岛 🇦🇨
啊	啊 😦
埃及	埃及 🇪🇬
埃塞俄比亚	埃塞俄比亚 🇪🇹
爱尔兰	爱尔兰 🇮🇪
爱你的手势	爱你的手势 🤟
爱沙尼亚	爱沙尼亚 🇪🇪
安道尔	安道尔 🇦🇩
安哥拉	安哥拉 🇦🇴
安圭拉	安圭拉 🇦🇮
安静的脸	安静的脸 🤫
安全别针	安全别针 🧷
安提瓜和巴布达	安提瓜和巴布达 🇦🇬
庵点	庵点 〽️
井	井 #️⃣
十	十 🔟
按摩	按摩 💆
傲慢	傲慢 😤
奥地利	奥地利 🇦🇹
奥兰群岛	奥兰群岛 🇦🇽
奥姆	奥姆 🕉️
澳大利亚	澳大利亚 🇦🇺
八点	八点 🕗
八点半	八点半 🕣
八角星	八角星 ✴️
八轮辐星号	八轮辐星号 ✳️
巴巴多斯	巴巴多斯 🇧🇧
巴布亚新几内亚	巴布亚新几内亚 🇵🇬
巴哈马	巴哈马 🇧🇸
巴基斯坦	巴基斯坦 🇵🇰
巴拉圭	巴拉圭 🇵🇾
巴勒斯坦领土	巴勒斯坦领土 🇵🇸
巴林	巴林 🇧🇭
巴拿马	巴拿马 🇵🇦
巴西	巴西 🇧🇷
芭蕾舞鞋	芭蕾舞鞋 🩰
霸王龙	霸王龙 🦖
白大褂	白大褂 🥼
白俄罗斯	白俄罗斯 🇧🇾
白花	白花 💮
白领	白领 🧑‍💼
白色方形按钮	白色方形按钮 🔳
白色感叹号	白色感叹号 ❕
白色问号	白色问号 ❔
白色小方块	白色小方块 ▫️
白色圆	白色圆 ⚪
白色中方块	白色中方块 ◻️
白色中小方块	白色中小方块 ◽
白十字头盔	白十字头盔 ⛑️
白线大方框	白线大方框 ⬜
白心	白心 🤍
白羊座	白羊座 ♈
百合花饰	百合花饰 ⚜️
百慕大	百慕大 🇧🇲
扳手	扳手 🔧
班卓琴	班卓琴 🪕
斑马	斑马 🦓
板球	板球 🏏
版权	版权 ©️
办公楼	办公楼 🏢
棒棒糖	棒棒糖 🍭
棒球	棒球 ⚾
包裹	包裹 📦
宝宝	宝宝 🚼
宝石	宝石 💎
保加利亚	保加利亚 🇧🇬
保龄球	保龄球 🎳
报纸	报纸 📰
报纸卷	报纸卷 🗞️
抱抱	抱抱 🤗
豹子	豹子 🐆
爆米花	爆米花 🍿
爆炸	爆炸 💥
爆炸头	爆炸头 🤯
爆竹	爆竹 🧨
北极熊	北极熊 🐻‍❄️
北马里亚纳群岛	北马里亚纳群岛 🇲🇵
北马其顿	北马其顿 🇲🇰
贝宁	贝宁 🇧🇯
备忘录	备忘录 📝
鼻子	鼻子 👃
匕首	匕首 🗡️
比基尼	比基尼 👙
比利时	比利时 🇧🇪
笔	笔 🖊️
笔记本	笔记本 📓
笔记本电脑	笔记本电脑 💻
毕业帽	毕业帽 🎓
闭嘴	闭嘴 🤐
蝙蝠	蝙蝠 🦇
扁面包	扁面包 🫓
便利店	便利店 🏪
标签	标签 🏷️
标签页	标签页 📑
标语牌	标语牌 🪧
表演艺术	表演艺术 🎭
别墅	别墅 🏡
冰岛	冰岛 🇮🇸
冰壶	冰壶 🥌
冰块	冰块 🧊
冰淇淋	冰淇淋 🍨
冰球	冰球 🏒
兵	兵 ♟️
饼干	饼干 🍪
波多黎各	波多黎各 🇵🇷
波兰	波兰 🇵🇱
波浪型破折号	波浪型破折号 〰️
波斯尼亚和黑塞哥维那	波斯尼亚和黑塞哥维那 🇧🇦
玻利维亚	玻利维亚 🇧🇴
菠萝	菠萝 🍍
播放按钮	播放按钮 ▶️
播放或暂停按钮	播放或暂停按钮 ⏯️
伯利兹	伯利兹 🇧🇿
博茨瓦纳	博茨瓦纳 🇧🇼
搏动的心	搏动的心 💗
捕鼠器	捕鼠器 🪤
哺乳的男人	哺乳的男人 👨‍🍼
哺乳的女人	哺乳的女人 👩‍🍼
哺乳的人	哺乳的人 🧑‍🍼
不丹	不丹 🇧🇹
不高兴	不高兴 😒
不满	不满 ☹️
不说	不说 🤭
布基纳法索	布基纳法索 🇧🇫
布隆迪	布隆迪 🇧🇮
布韦岛	布韦岛 🇧🇻
彩罐	彩罐 🪅
彩虹	彩虹 🌈
彩虹旗	彩虹旗 🏳️‍🌈
菜刀	菜刀 🔪
餐具	餐具 🍽️
残月	残月 🌘
仓鼠	仓鼠 🐹
苍蝇	苍蝇 🪰
草莓	草莓 🍓
厕所	厕所 🚾
侧手翻	侧手翻 🤸
叉号	叉号 ❌
叉号按钮	叉号按钮 ❎
茶壶	茶壶 🫖
颤抖	颤抖 🫨
场记板	场记板 🎬
敞蓬小型载货卡车	敞蓬小型载货卡车 🛻
超级大坏蛋	超级大坏蛋 🦹
超级英雄	超级英雄 🦸
朝鲜	朝鲜 🇰🇵
朝右的拳头	朝右的拳头 🤜
朝左的话语气泡	朝左的话语气泡 🗨️
朝左的拳头	朝左的拳头 🤛
车轮	车轮 🛞
车站	车站 🚉
沉默	沉默 😶
沉思	沉思 😔
成人	成人 🧑
城市风光	城市风光 🏙️
城市黄昏	城市黄昏 🌆
乘号	乘号 ✖️
程序员	程序员 🧑‍💻
橙色大菱形	橙色大菱形 🔶
橙色方块	橙色方块 🟧
橙色书本	橙色书本 📙
橙色小菱形	橙色小菱形 🔸
橙色圆	橙色圆 🟠
橙心	橙心 🧡
吃惊	吃惊 😮
齿轮	齿轮 ⚙️
赤道几内亚	赤道几内亚 🇬🇶
翅膀	翅膀 🪽
冲浪	冲浪 🏄
冲浪的男人	冲浪的男人 🏄‍♂️
冲浪的女人	冲浪的女人 🏄‍♀️
臭鼬	臭鼬 🦨
出拳	出拳 👊
出租车	出租车 🚕
除	除 ➗
厨师	厨师 🧑‍🍳
处女座	处女座 ♍
穿礼服的男人	穿礼服的男人 🤵‍♂️
穿礼服的女人	穿礼服的女人 🤵‍♀️
穿燕尾服的人	穿燕尾服的人 🤵
传真机	传真机 📠
船	船 🚢
窗户	窗户 🪟
床	床 🛏️
创可贴	创可贴 🩹
锤子	锤子 🔨
锤子与扳手	锤子与扳手 🛠️
锤子与镐	锤子与镐 ⚒️
唇膏	唇膏 💄
唇印	唇印 💋
磁铁	磁铁 🧲
刺猬	刺猬 🦔
粗等号	粗等号 🟰
粗美元符号	粗美元符号 💲
打高尔夫的人	打高尔夫的人 🏌️
打呵欠	打呵欠 🥱
打开的书本	打开的书本 📖
打开的锁	打开的锁 🔓
打开的文件夹	打开的文件夹 📂
打雷	打雷 🌩️
打喷嚏	打喷嚏 🤧
打印机	打印机 🖨️
打坐的男人	打坐的男人 🧘‍♂️
打坐的女人	打坐的女人 🧘‍♀️
大便	大便 💩
大风	大风 🌬️
大象	大象 🐘
大小王	大小王 🃏
大笑	大笑 😄
大笑的猫	大笑的猫 😺
大猩猩	大猩猩 🦍
大野牛	大野牛 🦬
带单片眼镜的脸	带单片眼镜的脸 🧐
带经纬线的地球	带经纬线的地球 🌐
带卷边的页面	带卷边的页面 📃
带框的画	带框的画 🖼️
带头饰的女人	带头饰的女人 🧕
带吸管杯	带吸管杯 🥤
带心的夫妇	带心的夫妇 👩‍❤️‍👨
带有箭头的手机	带有箭头的手机 📲
带圆点的菱形	带圆点的菱形 💠
带中间点的六芒星	带中间点的六芒星 🔯
袋棍球	袋棍球 🥍
袋鼠	袋鼠 🦘
戴瓜皮帽的人	戴瓜皮帽的人 👲
戴头巾的人	戴头巾的人 👳
戴头纱的男人	戴头纱的男人 👰‍♂️
戴头纱的女人	戴头纱的女人 👰‍♀️
戴头纱的人	戴头纱的人 👰
戴兔耳朵的人	戴兔耳朵的人 👯
戴兔子耳朵的男人们	戴兔子耳朵的男人们 👯‍♂️
戴兔子耳朵的女人们	戴兔子耳朵的女人们 👯‍♀️
戴王冠的人	戴王冠的人 🫅
戴助听器的耳朵	戴助听器的耳朵 🦻
丹麦	丹麦 🇩🇰
担心	担心 😟
单轨	单轨 🚝
单选按钮	单选按钮 🔘
单眼吐舌	单眼吐舌 😜
蛋	蛋 🥚
刀叉	刀叉 🍴
导盲犬	导盲犬 🦮
倒垃圾	倒垃圾 🚮
倒脸	倒脸 🙃
倒退按钮	倒退按钮 ◀️
稻子	稻子 🌾
得意	得意 😏
德国	德国 🇩🇪
地球上的美洲	地球上的美洲 🌎
地球上的欧洲非洲	地球上的欧洲非洲 🌍
地球上的亚洲澳洲	地球上的亚洲澳洲 🌏
地铁	地铁 🚇
灯笼椒	灯笼椒 🫑
灯泡	灯泡 💡
登山鞋	登山鞋 🥾
低亮度按钮	低亮度按钮 🔅
低音量的扬声器	低音量的扬声器 🔈
迪戈加西亚岛	迪戈加西亚岛 🇩🇬
点头	点头 🙂‍↕️
电池	电池 🔋
电池电量不足	电池电量不足 🪫
电动轮椅	电动轮椅 🦼
电话	电话 ☎️
电话听筒	电话听筒 📞
电脑光盘	电脑光盘 💽
电脑鼠标	电脑鼠标 🖱️
电平滑块	电平滑块 🎚️
电视机	电视机 📺
电梯	电梯 🛗
电影放映机	电影放映机 📽️
电影摄影机	电影摄影机 🎥
电影院	电影院 🎦
电源插头	电源插头 🔌
电子邮件	电子邮件 📧
钓鱼竿	钓鱼竿 🎣
调色盘	调色盘 🎨
定时器	定时器 ⏲️
东帝汶	东帝汶 🇹🇱
东京塔	东京塔 🗼
东正教十字架	东正教十字架 ☦️
洞	洞 🕳️
豆	豆 🫘
独角兽	独角兽 🦄
独木舟	独木舟 🛶
渡渡鸟	渡渡鸟 🦤
渡轮	渡轮 ⛴️
短裤	短裤 🩳
断链	断链 ⛓️‍💥
盾牌	盾牌 🛡️
多哥	多哥 🇹🇬
多个音符	多个音符 🎶
多米尼加共和国	多米尼加共和国 🇩🇴
多米尼克	多米尼克 🇩🇲
多云	多云 🌥️
俄罗斯	俄罗斯 🇷🇺
娥眉月	娥眉月 🌒
鹅	鹅 🪿
厄瓜多尔	厄瓜多尔 🇪🇨
厄立特里亚	厄立特里亚 🇪🇷
恶魔微笑	恶魔微笑 😈
恶心	恶心 🤢
鳄梨	鳄梨 🥑
鳄鱼	鳄鱼 🐊
儿童	儿童 🧒
儿童过街	儿童过街 🚸
耳朵	耳朵 👂
耳机	耳机 🎧
发财	发财 🤑
发夹	发夹 🪮
发件箱	发件箱 📤
发烧	发烧 🤒
法蒂玛之手	法蒂玛之手 🪬
法官	法官 🧑‍⚖️
法国	法国 🇫🇷
法轮	法轮 ☸️
法罗群岛	法罗群岛 🇫🇴
法师	法师 🧙
法式长棍面包	法式长棍面包 🥖
法属波利尼西亚	法属波利尼西亚 🇵🇫
法属圭亚那	法属圭亚那 🇬🇫
法属南部领地	法属南部领地 🇹🇫
法属圣马丁	法属圣马丁 🇲🇫
帆船	帆船 ⛵
翻白眼	翻白眼 🙄
反手食指向上指	反手食指向上指 👆
反手食指向下指	反手食指向下指 👇
反手食指向右指	反手食指向右指 👉
反手食指向左指	反手食指向左指 👈
返回箭头	返回箭头 🔙
饭团	饭团 🍙
梵蒂冈	梵蒂冈 🇻🇦
方片	方片 ♦️
房屋建筑	房屋建筑 🏘️
房子	房子 🏠
放声大哭	放声大哭 😭
飞碟	飞碟 🛸
飞机	飞机 ✈️
飞盘	飞盘 🥏
飞吻	飞吻 😘
飞行员	飞行员 🧑‍✈️
非礼勿视	非礼勿视 🙈
非礼勿听	非礼勿听 🙉
非礼勿言	非礼勿言 🙊
非饮用水	非饮用水 🚱
菲律宾	菲律宾 🇵🇭
斐济	斐济 🇫🇯
肺	肺 🫁
废墟	废墟 🏚️
芬兰	芬兰 🇫🇮
粉红色的心	粉红色的心 🩷
愤怒话语气泡	愤怒话语气泡 🗯️
风吹叶落	风吹叶落 🍃
风铃	风铃 🎐
风信子	风信子 🪻
风筝	风筝 🪁
枫叶	枫叶 🍁
蜂蜜	蜂蜜 🍯
凤凰	凤凰 🐦‍🔥
缝合针	缝合针 🪡
芙蓉	芙蓉 🌺
佛得角	佛得角 🇨🇻
服务铃	服务铃 🛎️
服务犬	服务犬 🐕‍🦺
辐射	辐射 ☢️
福克兰群岛	福克兰群岛 🇫🇰
斧头	斧头 🪓
富士山	富士山 🗻
感冒	感冒 😷
感叹疑问号	感叹疑问号 ⁉️
橄榄	橄榄 🫒
干杯	干杯 🍻
冈比亚	冈比亚 🇬🇲
刚果布	刚果布 🇨🇬
刚果金	刚果金 🇨🇩
钢笔	钢笔 🖋️
钢笔尖	钢笔尖 ✒️
高尔夫球洞	高尔夫球洞 ⛳
高跟鞋	高跟鞋 👠
高亮度按钮	高亮度按钮 🔆
高速公路	高速公路 🛣️
高速列车	高速列车 🚄
高压	高压 ⚡
高音量的扬声器	高音量的扬声器 🔊
哥伦比亚	哥伦比亚 🇨🇴
哥斯达黎加	哥斯达黎加 🇨🇷
鸽	鸽 🕊️
歌手	歌手 🧑‍🎤
格林纳达	格林纳达 🇬🇩
格陵兰	格陵兰 🇬🇱
格鲁吉亚	格鲁吉亚 🇬🇪
给我打电话	给我打电话 🤙
根西岛	根西岛 🇬🇬
工厂	工厂 🏭
工具箱	工具箱 🧰
工人	工人 🧑‍🏭
弓和箭	弓和箭 🏹
公鸡	公鸡 🐓
公交车	公交车 🚌
公交车站	公交车站 🚏
公牛	公牛 🐂
公文包	公文包 💼
公羊	公羊 🐏
公主	公主 👸
勾号	勾号 ✔️
勾号按钮	勾号按钮 ✅
勾选框	勾选框 ☑️
狗	狗 🐕
狗脸	狗脸 🐶
购物车	购物车 🛒
购物袋	购物袋 🛍️
古巴	古巴 🇨🇺
古典建筑	古典建筑 🏛️
骨灰缸	骨灰缸 ⚱️
骨头	骨头 🦴
鼓	鼓 🥁
鼓掌	鼓掌 👏
瓜德罗普	瓜德罗普 🇬🇵
挂钩	挂钩 🪝
拐杖	拐杖 🩼
关岛	关岛 🇬🇺
关东煮	关东煮 🍢
棺材	棺材 ⚰️
罐	罐 🫙
罐头食品	罐头食品 🥫
光盘	光盘 💿
圭亚那	圭亚那 🇬🇾
龟	龟 🐢
轨道车	轨道车 🚃
轨迹球	轨迹球 🖲️
鬼	鬼 👻
贵宾犬	贵宾犬 🐩
国家公园	国家公园 🏞️
过山车	过山车 🎢
哈哈	哈哈 😃
哈萨克斯坦	哈萨克斯坦 🇰🇿
海豹	海豹 🦭
海盗旗	海盗旗 🏴‍☠️
海地	海地 🇭🇹
海关	海关 🛃
海狸	海狸 🦫
海螺	海螺 🐚
海绵	海绵 🧽
海豚	海豚 🐬
害怕	害怕 😨
含泪的笑脸	含泪的笑脸 🥲
韩国	韩国 🇰🇷
汉堡	汉堡 🍔
汗	汗 😓
汗滴	汗滴 💦
航班降落	航班降落 🛬
航班起飞	航班起飞 🛫
好吃	好吃 😋
好崇拜哦	好崇拜哦 🤩
耗子	耗子 🐀
呵呵	呵呵 🙂
合上的书本	合上的书本 📕
合上的锁	合上的锁 🔒
和服	和服 👘
和平符号	和平符号 ☮️
河马	河马 🦛
河豚	河豚 🐡
荷兰	荷兰 🇳🇱
荷属加勒比区	荷属加勒比区 🇧🇶
荷属圣马丁	荷属圣马丁 🇸🇽
盒饭	盒饭 🍱
赫德岛和麦克唐纳群岛	赫德岛和麦克唐纳群岛 🇭🇲
黑猫	黑猫 🐈‍⬛
黑鸟	黑鸟 🐦‍⬛
黑色方形按钮	黑色方形按钮 🔲
黑色小方块	黑色小方块 ▪️
黑色圆	黑色圆 ⚫
黑色中方块	黑色中方块 ◼️
黑色中小方块	黑色中小方块 ◾
黑山	黑山 🇲🇪
黑桃	黑桃 ♠️
黑线大方框	黑线大方框 ⬛
黑心	黑心 🖤
嘿嘿	嘿嘿 😀
横向的红绿灯	横向的红绿灯 🚥
红包	红包 🧧
红灯笼	红灯笼 🏮
红辣椒	红辣椒 🌶️
红毛猩猩	红毛猩猩 🦧
红苹果	红苹果 🍎
红色倒三角	红色倒三角 🔻
红色方块	红色方块 🟥
红色感叹号	红色感叹号 ❗
红色空心圆圈	红色空心圆圈 ⭕
红色问号	红色问号 ❓
红色圆	红色圆 🔴
红色正三角	红色正三角 🔺
红桃	红桃 ♥️
红心	红心 ❤️
红中	红中 🀄
洪都拉斯	洪都拉斯 🇭🇳
猴头	猴头 🐵
猴子	猴子 🐒
呼气	呼气 😮‍💨
狐狸	狐狸 🦊
胡萝卜	胡萝卜 🥕
蝴蝶	蝴蝶 🦋
蝴蝶结	蝴蝶结 🎀
护目镜	护目镜 🥽
护照检查	护照检查 🛂
花痴	花痴 😍
花痴的猫	花痴的猫 😻
花生	花生 🥜
花束	花束 💐
花札	花札 🎴
华夫饼	华夫饼 🧇
滑板	滑板 🛹
滑板车	滑板车 🛴
滑冰	滑冰 ⛸️
滑稽	滑稽 🤪
滑雪	滑雪 🎿
滑雪板	滑雪板 🏂
滑雪的人	滑雪的人 ⛷️
划艇	划艇 🚣
画笔	画笔 🖌️
话语气泡	话语气泡 💬
怀孕的男人	怀孕的男人 🫃
怀孕的人	怀孕的人 🫄
獾	獾 🦡
浣熊	浣熊 🦝
皇冠	皇冠 👑
黄瓜	黄瓜 🥒
黄色方块	黄色方块 🟨
黄色圆	黄色圆 🟡
黄心	黄心 💛
黄油	黄油 🧈
灰心	灰心 🩶
挥手	挥手 👋
回收标志	回收标志 ♻️
回形针	回形针 📎
回旋镖	回旋镖 🪃
彗星	彗星 ☄️
婚礼	婚礼 💒
活塞	活塞 🪠
火车	火车 🚆
火花	火花 ❇️
火鸡	火鸡 🦃
火箭	火箭 🚀
火烈鸟	火烈鸟 🦩
火山	火山 🌋
火上之心	火上之心 ❤️‍🔥
火焰	火焰 🔥
货币兑换	货币兑换 💱
货车	货车 🚚
击剑选手	击剑选手 🤺
机器人	机器人 🤖
机械手臂	机械手臂 🦾
机械腿	机械腿 🦿
肌肉	肌肉 💪
鸡	鸡 🐔
鸡尾酒	鸡尾酒 🍸
基里巴斯	基里巴斯 🇰🇮
吉布提	吉布提 🇩🇯
吉尔吉斯斯坦	吉尔吉斯斯坦 🇰🇬
吉他	吉他 🎸
极度痛苦	极度痛苦 😧
几内亚	几内亚 🇬🇳
几内亚比绍	几内亚比绍 🇬🇼
技工	技工 🧑‍🔧
寄存行李	寄存行李 🛅
加	加 ➕
加拿大	加拿大 🇨🇦
加纳	加纳 🇬🇭
加纳利群岛	加纳利群岛 🇮🇨
加蓬	加蓬 🇬🇦
夹钳	夹钳 🗜️
夹心饼	夹心饼 🥙
夹趾凉鞋	夹趾凉鞋 🩴
家禽的腿	家禽的腿 🍗
家庭	家庭 👪
甲虫	甲虫 🪲
奸笑的猫	奸笑的猫 😼
缄默	缄默 😯
煎蛋	煎蛋 🍳
柬埔寨	柬埔寨 🇰🇭
减	减 ➖
剪刀	剪刀 ✂️
剪贴板	剪贴板 📋
建筑工人	建筑工人 👷
星号键	星号键 *️⃣️
零	零 0️⃣
一	一 1️⃣
二	二 2️⃣
三	三 3️⃣
四	四 4️⃣
五	五 5️⃣
六	六 6️⃣
七	七 7️⃣
八	八 8️⃣
九	九 9️⃣
键盘	键盘 ⌨️
姜	姜 🫚
僵尸	僵尸 🧟
讲话泡泡中的眼睛	讲话泡泡中的眼睛 👁️‍🗨️
奖杯	奖杯 🏆
奖牌	奖牌 🏅
降落伞	降落伞 🪂
交叉的手指	交叉的手指 🤞
交叉放置的剑	交叉放置的剑 ⚔️
交叉旗	交叉旗 🎌
椒盐卷饼	椒盐卷饼 🥨
饺子	饺子 🥟
铰接式货车	铰接式货车 🚛
脚	脚 🦶
脚印	脚印 👣
教堂	教堂 ⛪
结	结 🪢
结束箭头	结束箭头 🔚
捷克	捷克 🇨🇿
戒指	戒指 💍
金牛座	金牛座 ♉
金牌	金牌 🥇
金色头发的人	金色头发的人 👱
津巴布韦	津巴布韦 🇿🇼
禁止	禁止 🚫
禁止乱扔垃圾	禁止乱扔垃圾 🚯
禁止使用手机	禁止使用手机 📵
禁止手势	禁止手势 🙅
禁止通行	禁止通行 ⛔
禁止吸烟	禁止吸烟 🚭
禁止响铃	禁止响铃 🔕
禁止行人通行	禁止行人通行 🚷
禁止自行车	禁止自行车 🚳
精灵	精灵 🧚
精装笔记本	精装笔记本 📔
鲸鱼	鲸鱼 🐋
警察	警察 👮
警车	警车 🚓
警车灯	警车灯 🚨
警告	警告 ⚠️
镜球	镜球 🪩
镜子	镜子 🪞
九点	九点 🕘
九点半	九点半 🕤
酒店	酒店 🏨
救护车	救护车 🚑
救生圈	救生圈 🛟
救生衣	救生衣 🦺
鞠躬	鞠躬 🙇
橘子	橘子 🍊
举白旗	举白旗 🏳️
举黑旗	举黑旗 🏴
举起拳头	举起拳头 ✊
举起手	举起手 ✋
举手	举手 🙋
举手的男人	举手的男人 🙋‍♂️
举手的女人	举手的女人 🙋‍♀️
举双手	举双手 🙌
举重	举重 🏋️
巨蟹座	巨蟹座 ♋
聚会笑脸	聚会笑脸 🥳
卷曲环	卷曲环 ➰
卷纸	卷纸 🧻
卷轴	卷轴 📜
撅嘴	撅嘴 🙎
噘嘴的男人	噘嘴的男人 🙎‍♂️
噘嘴的女人	噘嘴的女人 🙎‍♀️
军功章	军功章 🎖️
军用头盔	军用头盔 🪖
咖喱饭	咖喱饭 🍛
喀麦隆	喀麦隆 🇨🇲
卡片盒	卡片盒 🗃️
卡片索引	卡片索引 📇
卡塔尔	卡塔尔 🇶🇦
开花	开花 🌼
开曼群岛	开曼群岛 🇰🇾
开闪光灯的相机	开闪光灯的相机 📸
开香槟	开香槟 🍾
坎达	坎达 🪯
考拉	考拉 🐨
烤红薯	烤红薯 🍠
科科斯（基林）群岛	科科斯（基林）群岛 🇨🇨
科摩罗	科摩罗 🇰🇲
科索沃	科索沃 🇽🇰
科特迪瓦	科特迪瓦 🇨🇮
科威特	科威特 🇰🇼
科学家	科学家 🧑‍🔬
克尔白	克尔白 🕋
克利珀顿岛	克利珀顿岛 🇨🇵
克罗地亚	克罗地亚 🇭🇷
客轮	客轮 🛳️
肯尼亚	肯尼亚 🇰🇪
恳求的脸	恳求的脸 🥺
空巢	空巢 🪹
空轨	空轨 🚟
孔雀	孔雀 🦚
控制旋钮	控制旋钮 🎛️
枯萎的花	枯萎的花 🥀
哭	哭 😢
哭泣的猫	哭泣的猫 😿
骷髅	骷髅 ☠️
苦笑	苦笑 😅
库克群岛	库克群岛 🇨🇰
库拉索	库拉索 🇨🇼
跨性别符号	跨性别符号 ⚧️
跨性别旗	跨性别旗 🏳️‍⚧️
快进按钮	快进按钮 ⏩
快速上升按钮	快速上升按钮 ⏫
快速下降按钮	快速下降按钮 ⏬
快艇	快艇 🚤
快退按钮	快退按钮 ⏪
筷子	筷子 🥢
筐	筐 🧺
亏凸月	亏凸月 🌖
困	困 😪
困惑	困惑 😖
困扰	困扰 😕
扩音器	扩音器 📣
垃圾桶	垃圾桶 🗑️
拉炮彩带	拉炮彩带 🎉
拉脱维亚	拉脱维亚 🇱🇻
喇叭	喇叭 📢
蜡笔	蜡笔 🖍️
蜡烛	蜡烛 🕯️
来信	来信 📨
莱索托	莱索托 🇱🇸
蓝莓	蓝莓 🫐
蓝色大菱形	蓝色大菱形 🔷
蓝色方块	蓝色方块 🟦
蓝色书本	蓝色书本 📘
蓝色小菱形	蓝色小菱形 🔹
蓝色圆	蓝色圆 🔵
蓝心	蓝心 💙
篮球	篮球 🏀
缆车	缆车 🚠
狼	狼 🐺
浪花	浪花 🌊
老虎	老虎 🐅
老虎机	老虎机 🎰
老虎头	老虎头 🐯
老奶奶	老奶奶 👵
老年人	老年人 🧓
老师	老师 🧑‍🏫
老式钥匙	老式钥匙 🗝️
老鼠	老鼠 🐁
老鼠头	老鼠头 🐭
老挝	老挝 🇱🇦
老爷爷	老爷爷 👴
烙饼	烙饼 🥞
乐谱	乐谱 🎼
雷阵雨	雷阵雨 ⛈️
垒球	垒球 🥎
累	累 😫
累死了	累死了 😩
冷汗	冷汗 😰
冷脸	冷脸 🥶
冷漠	冷漠 😐
梨	梨 🍐
黎巴嫩	黎巴嫩 🇱🇧
礼帽	礼帽 🎩
礼物	礼物 🎁
理发	理发 💇
理发店	理发店 💈
鲤鱼旗	鲤鱼旗 🎏
立起的手背	立起的手背 🤚
立陶宛	立陶宛 🇱🇹
利比里亚	利比里亚 🇱🇷
利比亚	利比亚 🇱🇾
栗子	栗子 🌰
连起来的两个回形针	连起来的两个回形针 🖇️
连体泳衣	连体泳衣 🩱
连衣裙	连衣裙 👗
莲花	莲花 🪷
联合国	联合国 🇺🇳
脸发烧	脸发烧 🥵
脸红	脸红 😳
练武服	练武服 🥋
链接	链接 🔗
链条	链条 ⛓️
两点	两点 🕑
两点半	两点半 🕝
两颗心	两颗心 💕
列支敦士登	列支敦士登 🇱🇮
淋浴	淋浴 🚿
铃铛	铃铛 🔔
领带	领带 👔
留尼汪	留尼汪 🇷🇪
流口水	流口水 🤤
流星	流星 🌠
六点	六点 🕕
六点半	六点半 🕡
六芒星	六芒星 ✡️
龙	龙 🐉
龙卷风	龙卷风 🌪️
龙头	龙头 🐲
龙虾	龙虾 🦞
聋哑男人	聋哑男人 🧏‍♂️
聋哑女人	聋哑女人 🧏‍♀️
卢森堡	卢森堡 🇱🇺
卢旺达	卢旺达 🇷🇼
录像带	录像带 📼
录音室麦克风	录音室麦克风 🎙️
录制按钮	录制按钮 ⏺️
鹿	鹿 🦌
路面电车	路面电车 🚊
路障	路障 🚧
露营	露营 🏕️
轮椅标识	轮椅标识 ♿
罗马尼亚	罗马尼亚 🇷🇴
螺母与螺栓	螺母与螺栓 🔩
螺丝刀	螺丝刀 🪛
骆驼	骆驼 🐪
落叶	落叶 🍂
落叶树	落叶树 🌳
驴	驴 🫏
绿色方块	绿色方块 🟩
绿色沙拉	绿色沙拉 🥗
绿色书本	绿色书本 📗
绿色圆	绿色圆 🟢
绿心	绿心 💚
绿叶蔬菜	绿叶蔬菜 🥬
马	马 🐎
马达加斯加	马达加斯加 🇲🇬
马黛茶	马黛茶 🧉
马恩岛	马恩岛 🇮🇲
马尔代夫	马尔代夫 🇲🇻
马耳他	马耳他 🇲🇹
马拉维	马拉维 🇲🇼
马来西亚	马来西亚 🇲🇾
马里	马里 🇲🇱
马绍尔群岛	马绍尔群岛 🇲🇭
马提尼克	马提尼克 🇲🇶
马桶	马桶 🚽
马头	马头 🐴
马戏团帐篷	马戏团帐篷 🎪
马约特	马约特 🇾🇹
蚂蚁	蚂蚁 🐜
麦克风	麦克风 🎤
满月	满月 🌕
芒果	芒果 🥭
盲杖	盲杖 🦯
猫	猫 🐈
猫脸	猫脸 🐱
猫头鹰	猫头鹰 🦉
毛里求斯	毛里求斯 🇲🇺
毛里塔尼亚	毛里塔尼亚 🇲🇷
毛毛虫	毛毛虫 🐛
毛线	毛线 🧶
锚	锚 ⚓
玫瑰	玫瑰 🌹
梅花	梅花 ♣️
美国	美国 🇺🇸
美国本土外小岛屿	美国本土外小岛屿 🇺🇲
美人鱼	美人鱼 🧜‍♀️
美式橄榄球	美式橄榄球 🏈
美属萨摩亚	美属萨摩亚 🇦🇸
美属维尔京群岛	美属维尔京群岛 🇻🇮
美元	美元 💵
美洲鸵	美洲鸵 🦙
门	门 🚪
门松	门松 🎍
蒙古	蒙古 🇲🇳
蒙特塞拉特	蒙特塞拉特 🇲🇸
猛犸	猛犸 🦣
孟加拉国	孟加拉国 🇧🇩
眯眼吐舌	眯眼吐舌 😝
迷茫	迷茫 😶‍🌫️
猕猴桃	猕猴桃 🥝
米饼	米饼 🍘
米饭	米饭 🍚
秘鲁	秘鲁 🇵🇪
密克罗尼西亚	密克罗尼西亚 🇫🇲
蜜蜂	蜜蜂 🐝
免费按钮	免费按钮 🆓
缅甸	缅甸 🇲🇲
面包	面包 🍞
面包圈	面包圈 🥯
面条	面条 🍜
秒表	秒表 ⏱️
灭火器	灭火器 🧯
摩埃	摩埃 🗿
摩尔多瓦	摩尔多瓦 🇲🇩
摩羯座	摩羯座 ♑
摩洛哥	摩洛哥 🇲🇦
摩纳哥	摩纳哥 🇲🇨
摩天轮	摩天轮 🎡
摩托车	摩托车 🏍️
摩托艇	摩托艇 🛥️
蘑菇	蘑菇 🍄
魔棒	魔棒 🪄
莫桑比克	莫桑比克 🇲🇿
墨镜	墨镜 🕶️
墨镜笑脸	墨镜笑脸 😎
墨水笔和锁	墨水笔和锁 🔏
墨西哥	墨西哥 🇲🇽
墨西哥卷饼	墨西哥卷饼 🌮
墨西哥玉米煎饼	墨西哥玉米煎饼 🌯
墨西哥粽子	墨西哥粽子 🫔
母乳喂养	母乳喂养 🤱
母羊	母羊 🐑
牡蛎	牡蛎 🦪
拇指向上	拇指向上 👍
拇指向下	拇指向下 👎
木工锯	木工锯 🪚
木头	木头 🪵
墓碑	墓碑 🪦
纳米比亚	纳米比亚 🇳🇦
纳扎尔护身符	纳扎尔护身符 🧿
奶黄	奶黄 🍮
奶酪火锅	奶酪火锅 🫕
奶牛	奶牛 🐄
奶牛头	奶牛头 🐮
奶瓶	奶瓶 🍼
男白领	男白领 👨‍💼
男厕	男厕 🚹
男超级反派	男超级反派 🦹‍♂️
男超级英雄	男超级英雄 🦸‍♂️
男程序员	男程序员 👨‍💻
男厨师	男厨师 👨‍🍳
男法师	男法师 🧙‍♂️
男歌手	男歌手 👨‍🎤
男工人	男工人 👨‍🏭
男孩	男孩 👦
男技工	男技工 👨‍🔧
男精灵	男精灵 🧝‍♂️
男警官	男警官 👮‍♂️
男警卫	男警卫 💂‍♂️
男科学家	男科学家 👨‍🔬
男老师	男老师 👨‍🏫
男人	男人 👨
男人打手势不同意	男人打手势不同意 🙅‍♂️
男人打手势同意	男人打手势同意 🙆‍♂️
男人翻筋斗	男人翻筋斗 🤸‍♂️
男人跪着	男人跪着 🧎‍♂️
男人僵尸	男人僵尸 🧟‍♂️
男人接受按摩	男人接受按摩 💆‍♂️
男人精灵	男人精灵 🧞‍♂️
男人鞠躬	男人鞠躬 🙇‍♂️
男人理发	男人理发 💇‍♂️
男人耸肩	男人耸肩 🤷‍♂️
男人玩杂耍	男人玩杂耍 🤹‍♂️
男人捂脸	男人捂脸 🤦‍♂️
男人鱼	男人鱼 🧜‍♂️
男人站立	男人站立 🧍‍♂️
男人走路	男人走路 🚶‍♂️
男吸血鬼	男吸血鬼 🧛‍♂️
男仙子	男仙子 🧚‍♂️
男消防员	男消防员 👨‍🚒
男鞋	男鞋 👞
男性符号	男性符号 ♂️
男学生	男学生 👨‍🎓
男艺术家	男艺术家 👨‍🎨
男宇航员	男宇航员 👨‍🚀
男侦探	男侦探 🕵️‍♂️
男子戴着头巾	男子戴着头巾 👳‍♂️
男子法官	男子法官 👨‍⚖️
男子飞行员	男子飞行员 👨‍✈️
男子高尔夫球	男子高尔夫球 🏌️‍♂️
男子划艇	男子划艇 🚣‍♂️
男子建筑工人	男子建筑工人 👷‍♂️
男子健康工作者	男子健康工作者 👨‍⚕️
男子举起的手	男子举起的手 💁‍♂️
男子举重	男子举重 🏋️‍♂️
男子攀爬	男子攀爬 🧗‍♂️
男子山地自行车	男子山地自行车 🚵‍♂️
男子摔跤	男子摔跤 🤼‍♂️
男子玩手球	男子玩手球 🤾‍♂️
男子玩水球	男子玩水球 🤽‍♂️
南非	南非 🇿🇦
南瓜灯	南瓜灯 🎃
南极洲	南极洲 🇦🇶
南乔治亚和南桑威奇群岛	南乔治亚和南桑威奇群岛 🇬🇸
南苏丹	南苏丹 🇸🇸
脑	脑 🧠
瑙鲁	瑙鲁 🇳🇷
闹钟	闹钟 ⏰
内心活动气泡	内心活动气泡 💭
尼加拉瓜	尼加拉瓜 🇳🇮
尼泊尔	尼泊尔 🇳🇵
尼日尔	尼日尔 🇳🇪
尼日利亚	尼日利亚 🇳🇬
逆时针箭头按钮	逆时针箭头按钮 🔄
念珠	念珠 📿
鸟	鸟 🐦
捏合的手势	捏合的手势 🤏
捏手指	捏手指 🤌
柠檬	柠檬 🍋
牛仔裤	牛仔裤 👖
牛仔帽脸	牛仔帽脸 🤠
纽埃	纽埃 🇳🇺
农夫	农夫 👨‍🌾
农妇	农妇 👩‍🌾
农民	农民 🧑‍🌾
怒	怒 💢
怒火中烧	怒火中烧 😡
挪威	挪威 🇳🇴
诺福克岛	诺福克岛 🇳🇫
女白领	女白领 👩‍💼
女厕	女厕 🚺
女超级反派	女超级反派 🦹‍♀️
女超级英雄	女超级英雄 🦸‍♀️
女程序员	女程序员 👩‍💻
女厨师	女厨师 👩‍🍳
女法官	女法官 👩‍⚖️
女法师	女法师 🧙‍♀️
女飞行员	女飞行员 👩‍✈️
女歌手	女歌手 👩‍🎤
女工人	女工人 👩‍🏭
女孩	女孩 👧
女技工	女技工 👩‍🔧
女建筑工人	女建筑工人 👷‍♀️
女精灵	女精灵 🧝‍♀️
女警官	女警官 👮‍♀️
女警卫	女警卫 💂‍♀️
女科学家	女科学家 👩‍🔬
女老师	女老师 👩‍🏫
女帽	女帽 👒
女人	女人 👩
女式凉鞋	女式凉鞋 👡
女卫生工作者	女卫生工作者 👩‍⚕️
女吸血鬼	女吸血鬼 🧛‍♀️
女仙子	女仙子 🧚‍♀️
女消防员	女消防员 👩‍🚒
女性符号	女性符号 ♀️
女靴	女靴 👢
女学生	女学生 👩‍🎓
女艺术家	女艺术家 👩‍🎨
女宇航员	女宇航员 👩‍🚀
女侦探	女侦探 🕵️‍♀️
女装	女装 👚
女子高尔夫球	女子高尔夫球 🏌️‍♀️
女子划艇	女子划艇 🚣‍♀️
女子举重	女子举重 🏋️‍♀️
女子山地自行车	女子山地自行车 🚵‍♀️
女子摔跤	女子摔跤 🤼‍♀️
欧盟	欧盟 🇪🇺
欧元	欧元 💶
欧洲城堡	欧洲城堡 🏰
呕吐	呕吐 🤮
帕劳	帕劳 🇵🇼
拍球的男人	拍球的男人 ⛹️‍♂️
拍球的女人	拍球的女人 ⛹️‍♀️
排骨	排骨 🍖
排球	排球 🏐
派	派 🥧
攀爬的人	攀爬的人 🧗
盘腿的人	盘腿的人 🧘
抛接杂耍	抛接杂耍 🤹
刨冰	刨冰 🍧
跑步的男人	跑步的男人 🏃‍♂️
跑步的女人	跑步的女人 🏃‍♀️
跑步者	跑步者 🏃
跑鞋	跑鞋 👟
培根	培根 🥓
培养皿	培养皿 🧫
喷泉	喷泉 ⛲
喷水的鲸	喷水的鲸 🐳
盆栽植物	盆栽植物 🪴
碰杯	碰杯 🥂
披萨	披萨 🍕
皮特凯恩群岛	皮特凯恩群岛 🇵🇳
疲倦的猫	疲倦的猫 🙀
啤酒	啤酒 🍺
瓢虫	瓢虫 🐞
票	票 🎫
拼图	拼图 🧩
乒乓球	乒乓球 🏓
平底杯	平底杯 🥃
平底鞋	平底鞋 🥿
葡萄	葡萄 🍇
葡萄酒	葡萄酒 🍷
葡萄牙	葡萄牙 🇵🇹
七点	七点 🕖
七点半	七点半 🕢
七夕树	七夕树 🎋
骑山地车	骑山地车 🚵
骑自行车	骑自行车 🚴
骑自行车的男人	骑自行车的男人 🚴‍♂️
骑自行车的女人	骑自行车的女人 🚴‍♀️
企鹅	企鹅 🐧
气泡	气泡 🫧
气球	气球 🎈
汽车	汽车 🚗
铅笔	铅笔 ✏️
前台	前台 💁
钱包	钱包 👛
钱袋	钱袋 💰
潜水面罩	潜水面罩 🤿
浅蓝色的心	浅蓝色的心 🩵
巧克力	巧克力 🍫
茄子	茄子 🍆
亲亲	亲亲 😗
亲亲猫	亲亲猫 😽
亲吻	亲吻 💏
青柠	青柠 🍋‍🟩
青苹果	青苹果 🍏
青蛙	青蛙 🐸
轻轨	轻轨 🚈
倾倒液体	倾倒液体 🫗
清酒	清酒 🍶
清真寺	清真寺 🕌
情侣	情侣 💑
情人酒店	情人酒店 🏩
情书	情书 💌
晴偶有云	晴偶有云 🌤️
晴转雨	晴转雨 🌦️
球门	球门 🥅
曲棍球	曲棍球 🏑
趋势向上的图表	趋势向上的图表 📈
趋势向上且带有日元符号的图表	趋势向上且带有日元符号的图表 💹
趋势向下的图表	趋势向下的图表 📉
取款机	取款机 🏧
拳击手套	拳击手套 🥊
热茶	热茶 🍵
热带水果饮料	热带水果饮料 🍹
热带鱼	热带鱼 🐠
热狗	热狗 🌭
热饮	热饮 ☕
人的拥抱	人的拥抱 🫂
人像	人像 👤
人鱼	人鱼 🧜
忍者	忍者 🥷
忍住泪水	忍住泪水 🥹
日本	日本 🇯🇵
日本城堡	日本城堡 🏯
日本地图	日本地图 🗾
日本人形	日本人形 🎎
日本新手驾驶标志	日本新手驾驶标志 🔰
日本邮局	日本邮局 🏣
日出	日出 🌅
日历	日历 📅
日落	日落 🌇
打折	打折 🈹
服务费	服务费 🈂️
合格	合格 🈴
禁	禁 🈲
开始营业	开始营业 🈺
可接受	可接受 🉑
没有空位	没有空位 🈵
秘密	秘密 ㊙️
免费	免费 🈚
申请	申请 🈸
收费	收费 🈶
议价	议价 🉐
有空位	有空位 🈳
预留	预留 🈯
月总量	月总量 🈷️
这里	这里 🈁
祝贺	祝贺 ㊗️
日元	日元 💴
融化	融化 🫠
肉块	肉块 🥩
蠕虫	蠕虫 🪱
乳液瓶	乳液瓶 🧴
入场券	入场券 🎟️
软盘	软盘 💾
瑞典	瑞典 🇸🇪
瑞士	瑞士 🇨🇭
萨尔瓦多	萨尔瓦多 🇸🇻
萨克斯管	萨克斯管 🎷
萨摩亚	萨摩亚 🇼🇸
塞尔维亚	塞尔维亚 🇷🇸
塞拉利昂	塞拉利昂 🇸🇱
塞内加尔	塞内加尔 🇸🇳
塞浦路斯	塞浦路斯 🇨🇾
塞舌尔	塞舌尔 🇸🇨
赛车	赛车 🏎️
赛马	赛马 🏇
三叉戟徽章	三叉戟徽章 🔱
三点	三点 🕒
三点半	三点半 🕞
三角尺	三角尺 📐
三角裤	三角裤 🩲
三角旗	三角旗 🚩
三轮摩托车	三轮摩托车 🛺
三明治	三明治 🥪
三叶草	三叶草 ☘️
伞	伞 ☂️
扫帚	扫帚 🧹
沙发和灯	沙发和灯 🛋️
沙漏	沙漏 ⌛
沙漠	沙漠 🏜️
沙球	沙球 🪇
沙滩伞	沙滩伞 🏖️
沙特阿拉伯	沙特阿拉伯 🇸🇦
沙正往下流的沙漏	沙正往下流的沙漏 ⏳
纱丽	纱丽 🥻
鲨鱼	鲨鱼 🦈
山	山 ⛰️
山顶日出	山顶日出 🌄
山区铁路	山区铁路 🚞
山羊	山羊 🐐
珊瑚	珊瑚 🪸
闪亮	闪亮 ✨
闪亮的心	闪亮的心 💖
闪亮的星星	闪亮的星星 🌟
商标	商标 ™️
商场	商场 🏬
赏月	赏月 🎑
上下箭头	上下箭头 ↕️
上弦月	上弦月 🌓
上一个音轨按钮	上一个音轨按钮 ⏮️
舌头	舌头 👅
蛇	蛇 🐍
蛇夫座	蛇夫座 ⛎
射手座	射手座 ♐
摄像机	摄像机 📹
身份证	身份证 🪪
神社	神社 ⛩️
生气	生气 😠
生气的恶魔	生气的恶魔 👿
生气的猫	生气的猫 😾
生日蛋糕	生日蛋糕 🎂
生物危害	生物危害 ☣️
圣巴泰勒米	圣巴泰勒米 🇧🇱
圣诞岛	圣诞岛 🇨🇽
圣诞老人	圣诞老人 🎅
圣诞奶奶	圣诞奶奶 🤶
圣诞人	圣诞人 🧑‍🎄
圣诞树	圣诞树 🎄
圣多美和普林西比	圣多美和普林西比 🇸🇹
圣赫勒拿	圣赫勒拿 🇸🇭
圣基茨和尼维斯	圣基茨和尼维斯 🇰🇳
圣卢西亚	圣卢西亚 🇱🇨
圣马力诺	圣马力诺 🇸🇲
圣皮埃尔和密克隆群岛	圣皮埃尔和密克隆群岛 🇵🇲
圣文森特和格林纳丁斯	圣文森特和格林纳丁斯 🇻🇨
胜利手势	胜利手势 ✌️
失聪者	失聪者 🧏
失望	失望 😞
失望但如释重负	失望但如释重负 😥
狮子	狮子 🦁
狮子座	狮子座 ♌
施工	施工 🏗️
十点	十点 🕙
十点半	十点半 🕥
十二点	十二点 🕛
十二点半	十二点半 🕧
十一点	十一点 🕚
十一点半	十一点半 🕦
十字架	十字架 ✝️
石油桶	石油桶 🛢️
食人魔	食人魔 👹
食指向上指	食指向上指 ☝️
食指与拇指交叉的手	食指与拇指交叉的手 🫰
世界地图	世界地图 🗺️
试管	试管 🧪
匙	匙 🥄
收件箱	收件箱 📥
收据	收据 🧾
收起的伞	收起的伞 🌂
收音机	收音机 📻
收邮件	收邮件 📩
手表	手表 ⌚
手袋	手袋 👝
手电筒	手电筒 🔦
手动轮椅	手动轮椅 🦽
手风琴	手风琴 🪗
手机	手机 📱
手机关机	手机关机 📴
手拉手的两个男人	手拉手的两个男人 👬
手拉手的两个女人	手拉手的两个女人 👭
手拉手的两个人	手拉手的两个人 🧑‍🤝‍🧑
手拉手的一男一女	手拉手的一男一女 👫
手球	手球 🤾
手撕日历	手撕日历 📆
手套	手套 🧤
手提包	手提包 👜
手掌	手掌 🖐️
寿司	寿司 🍣
受伤	受伤 🤕
书	书 📚
书包	书包 🎒
书呆子脸	书呆子脸 🤓
书签	书签 🔖
输入大写拉丁字母	输入大写拉丁字母 🔠
输入符号	输入符号 🔣
输入拉丁字母	输入拉丁字母 🔤
输入数字	输入数字 🔢
输入小写拉丁字母	输入小写拉丁字母 🔡
薯条	薯条 🍟
树懒	树懒 🦥
竖中指	竖中指 🖕
摔跤选手	摔跤选手 🤼
双耳瓶	双耳瓶 🏺
双峰骆驼	双峰骆驼 🐫
双感叹号	双感叹号 ‼️
双卷曲环	双卷曲环 ➿
双人像	双人像 👥
双手合十	双手合十 🙏
双眼	双眼 👀
双鱼座	双鱼座 ♓
双子座	双子座 ♊
水滴	水滴 💧
水果蛋糕	水果蛋糕 🍰
水晶球	水晶球 🔮
水母	水母 🪼
水牛	水牛 🐃
水瓶座	水瓶座 ♒
水枪	水枪 🔫
水球	水球 🤽
水獭	水獭 🦦
睡着	睡着 💤
睡着了	睡着了 😴
顺时针垂直箭头	顺时针垂直箭头 🔃
说话	说话 🗣️
说谎	说谎 🤥
朔月	朔月 🌑
斯里兰卡	斯里兰卡 🇱🇰
斯洛伐克	斯洛伐克 🇸🇰
斯洛文尼亚	斯洛文尼亚 🇸🇮
斯瓦尔巴和扬马延	斯瓦尔巴和扬马延 🇸🇯
斯威士兰	斯威士兰 🇸🇿
四点	四点 🕓
四点半	四点半 🕟
四轮滑冰鞋	四轮滑冰鞋 🛼
四叶草	四叶草 🍀
松了口气	松了口气 😌
松鼠	松鼠 🐿️
松树	松树 🌲
耸肩	耸肩 🤷
苏丹	苏丹 🇸🇩
苏格兰	苏格兰 🏴󠁧󠁢󠁳󠁣󠁴󠁿
苏里南	苏里南 🇸🇷
蒜	蒜 🧄
算盘	算盘 🧮
随机播放音轨按钮	随机播放音轨按钮 🔀
所罗门群岛	所罗门群岛 🇸🇧
索道	索道 🚡
索马里	索马里 🇸🇴
索引分隔文件夹	索引分隔文件夹 🗂️
塔吉克斯坦	塔吉克斯坦 🇹🇯
台风	台风 🌀
台球	台球 🎱
台式电脑	台式电脑 🖥️
台湾	台湾 🇹🇼
太阳	太阳 ☀️
泰迪熊	泰迪熊 🧸
泰国	泰国 🇹🇭
坦桑尼亚	坦桑尼亚 🇹🇿
汤加	汤加 🇹🇴
糖	糖 🍬
躺在床上的人	躺在床上的人 🛌
桃	桃 🍑
套娃	套娃 🪆
特克斯和凯科斯群岛	特克斯和凯科斯群岛 🇹🇨
特里斯坦-达库尼亚群岛	特里斯坦-达库尼亚群岛 🇹🇦
特立尼达和多巴哥	特立尼达和多巴哥 🇹🇹
梯子	梯子 🪜
提取行李	提取行李 🛄
提示丝带	提示丝带 🎗️
体育馆	体育馆 🏟️
剃须刀	剃须刀 🪒
天秤座	天秤座 ♎
天鹅	天鹅 🦢
天妇罗	天妇罗 🍤
天平	天平 ⚖️
天蝎座	天蝎座 ♏
甜瓜	甜瓜 🍈
甜甜圈	甜甜圈 🍩
挑眉	挑眉 🤨
条形图	条形图 📊
跳舞的男人	跳舞的男人 🕺
跳舞的女人	跳舞的女人 💃
铁镐	铁镐 ⛏️
铁轨	铁轨 🛤️
听诊器	听诊器 🩺
停车按钮	停车按钮 🅿️
停止按钮	停止按钮 ⏹️
停止标志	停止标志 🛑
铜牌	铜牌 🥉
桶	桶 🪣
痛苦	痛苦 😣
偷看	偷看 🫣
头骨	头骨 💀
头昏眼花	头昏眼花 🥴
头晕	头晕 💫
投票箱	投票箱 🗳️
骰子	骰子 🎲
突尼斯	突尼斯 🇹🇳
图钉	图钉 📌
图瓦卢	图瓦卢 🇹🇻
涂指甲油	涂指甲油 💅
土豆	土豆 🥔
土耳其	土耳其 🇹🇷
土库曼斯坦	土库曼斯坦 🇹🇲
吐舌	吐舌 😛
兔子	兔子 🐇
兔子头	兔子头 🐰
团子	团子 🍡
推出按钮	推出按钮 ⏏️
腿	腿 🦵
托克劳	托克劳 🇹🇰
拖拉机	拖拉机 🚜
驼鹿	驼鹿 🫎
瓦肯举手礼	瓦肯举手礼 🖖
瓦利斯和富图纳	瓦利斯和富图纳 🇼🇫
瓦努阿图	瓦努阿图 🇻🇺
袜子	袜子 🧦
外卖盒	外卖盒 🥡
外套	外套 🧥
外星怪物	外星怪物 👾
外星人	外星人 👽
弯月	弯月 🌙
豌豆荚	豌豆荚 🫛
玩球	玩球 ⛹️
碗勺	碗勺 🥣
王子	王子 🤴
网球	网球 🎾
望远镜	望远镜 🔭
危地马拉	危地马拉 🇬🇹
威尔士	威尔士 🏴󠁧󠁢󠁷󠁬󠁳󠁿
微微不满	微微不满 🙁
微笑	微笑 ☺️
微笑的猫	微笑的猫 😸
微笑的上弦月	微笑的上弦月 🌛
微笑的朔月	微笑的朔月 🌚
微笑的太阳	微笑的太阳 🌞
微笑的下弦月	微笑的下弦月 🌜
微笑的月亮	微笑的月亮 🌝
微笑亲亲	微笑亲亲 😙
微笑天使	微笑天使 😇
围巾	围巾 🧣
伪装的脸	伪装的脸 🥸
尾气	尾气 💨
委内瑞拉	委内瑞拉 🇻🇪
卫兵	卫兵 💂
卫生工作者	卫生工作者 🧑‍⚕️
卫生间	卫生间 🚻
卫星	卫星 🛰️
卫星天线	卫星天线 📡
温度计	温度计 🌡️
温泉	温泉 ♨️
文件	文件 📄
文件柜	文件柜 🗄️
文件夹	文件夹 📁
文莱	文莱 🇧🇳
蚊子	蚊子 🦟
吻	吻 👩‍❤️‍💋‍👨
蜗牛	蜗牛 🐌
握手	握手 🤝
乌干达	乌干达 🇺🇬
乌克兰	乌克兰 🇺🇦
乌拉圭	乌拉圭 🇺🇾
乌贼	乌贼 🦑
乌兹别克斯坦	乌兹别克斯坦 🇺🇿
无待收信件	无待收信件 📪
无轨电车	无轨电车 🚎
无人荒岛	无人荒岛 🏝️
无限	无限 ♾️
无线	无线 🛜
无新信件	无新信件 📭
无语	无语 😑
五彩纸屑球	五彩纸屑球 🎊
五点	五点 🕔
五点半	五点半 🕠
捂脸	捂脸 🤦
舞动的心	舞动的心 💞
雾	雾 🌫️
西班牙	西班牙 🇪🇸
西瓜	西瓜 🍉
西红柿	西红柿 🍅
西兰花	西兰花 🥦
西撒哈拉	西撒哈拉 🇪🇭
西装革履的人	西装革履的人 🕴️
吸血鬼	吸血鬼 🧛
希腊	希腊 🇬🇷
犀牛	犀牛 🦏
蜥蜴	蜥蜴 🦎
蜥蜴类	蜥蜴类 🦕
嘻嘻	嘻嘻 😁
蟋蟀	蟋蟀 🦗
洗澡的人	洗澡的人 🛀
喜笑颜开	喜笑颜开 🥰
系有缎带的心	系有缎带的心 💝
细菌	细菌 🦠
虾	虾 🦐
下跪者	下跪者 🧎
下弦月	下弦月 🌗
下雪	下雪 🌨️
下一个音轨按钮	下一个音轨按钮 ⏭️
下雨	下雨 🌧️
吓死了	吓死了 😱
仙人掌	仙人掌 🌵
显微镜	显微镜 🔬
线	线 🧵
线圈本	线圈本 🗒️
线圈日历	线圈日历 🗓️
相机	相机 📷
香蕉	香蕉 🍌
香烟	香烟 🚬
想一想	想一想 🤔
向日葵	向日葵 🌻
向上箭头	向上箭头 ⬆️
向上三角形按钮	向上三角形按钮 🔼
向下箭头	向下箭头 ⬇️
向下三角形按钮	向下三角形按钮 🔽
向右的手	向右的手 🫱
向右箭头	向右箭头 ➡️
向右推	向右推 🫸
向左的手	向左的手 🫲
向左箭头	向左箭头 ⬅️
向左推	向左推 🫷
消防车	消防车 🚒
消防员	消防员 🧑‍🚒
小巴	小巴 🚐
小宝贝	小宝贝 👶
小丑脸	小丑脸 🤡
小号	小号 🎺
小鸡	小鸡 🐤
小鸡破壳	小鸡破壳 🐣
小精灵	小精灵 🧝
小提琴	小提琴 🎻
小天使	小天使 👼
小屋	小屋 🛖
小型飞机	小型飞机 🛩️
小型摩托车	小型摩托车 🛵
小妖精	小妖精 👺
笑出眼泪的猫	笑出眼泪的猫 😹
笑得满地打滚	笑得满地打滚 🤣
笑哭了	笑哭了 😂
蝎子	蝎子 🦂
斜眼笑	斜眼笑 😆
写字	写字 ✍️
蟹	蟹 🦀
心碎	心碎 💔
心叹号	心叹号 ❣️
心跳	心跳 💓
心型装饰	心型装饰 💟
心脏器官	心脏器官 🫀
心中箭了	心中箭了 💘
新加坡	新加坡 🇸🇬
新喀里多尼亚	新喀里多尼亚 🇳🇨
新西兰	新西兰 🇳🇿
信封	信封 ✉️
信号强度条	信号强度条 📶
信息	信息 ℹ️
信用卡	信用卡 💳
星星	星星 ⭐
星月	星月 ☪️
行李箱	行李箱 🧳
行人	行人 🚶
幸运饼干	幸运饼干 🥠
姓名牌	姓名牌 📛
匈牙利	匈牙利 🇭🇺
熊	熊 🐻
熊猫	熊猫 🐼
休达及梅利利亚	休达及梅利利亚 🇪🇦
修复受伤的心灵	修复受伤的心灵 ❤️‍🩹
羞涩亲亲	羞涩亲亲 😚
羞涩微笑	羞涩微笑 😊
虚线脸	虚线脸 🫥
叙利亚	叙利亚 🇸🇾
旋转木马	旋转木马 🎠
穴居巨怪	穴居巨怪 🧌
学生	学生 🧑‍🎓
学校	学校 🏫
雪花	雪花 ❄️
雪橇	雪橇 🛷
雪人	雪人 ⛄
雪山	雪山 🏔️
雪与雪人	雪与雪人 ☃️
血滴	血滴 🩸
寻呼机	寻呼机 📟
鸭舌帽	鸭舌帽 🧢
鸭子	鸭子 🦆
牙齿	牙齿 🦷
牙买加	牙买加 🇯🇲
牙刷	牙刷 🪥
亚美尼亚	亚美尼亚 🇦🇲
烟花	烟花 🎇
岩石	岩石 🪨
盐	盐 🧂
眼睛	眼睛 👁️
眼镜	眼镜 👓
焰火	焰火 🎆
羊角面包	羊角面包 🥐
阳伞	阳伞 ⛱️
洋葱	洋葱 🧅
妖怪	妖怪 🧞
摇滚	摇滚 🤘
摇头	摇头 🙂‍↔️
咬住嘴唇	咬住嘴唇 🫦
药草	药草 🌿
药丸	药丸 💊
钥匙	钥匙 🔑
钥匙和锁	钥匙和锁 🔐
椰子	椰子 🥥
也门	也门 🇾🇪
野猪	野猪 🐗
夜幕下的桥	夜幕下的桥 🌉
夜晚	夜晚 🌃
一百分	一百分 💯
一杯奶	一杯奶 🥛
一点	一点 🕐
一点半	一点半 🕜
一锅食物	一锅食物 🍲
伊拉克	伊拉克 🇮🇶
伊朗	伊朗 🇮🇷
医疗标志	医疗标志 ⚕️
医院	医院 🏥
已静音的扬声器	已静音的扬声器 🔇
以色列	以色列 🇮🇱
椅子	椅子 🪑
艺术家	艺术家 🧑‍🎨
意大利	意大利 🇮🇹
意粉	意粉 🍝
阴	阴 ⛅
阴阳	阴阳 ☯️
音符	音符 🎵
音乐键盘	音乐键盘 🎹
银河	银河 🌌
银牌	银牌 🥈
银行	银行 🏦
饮料盒	饮料盒 🧃
饮用水	饮用水 🚰
印度	印度 🇮🇳
印度尼西亚	印度尼西亚 🇮🇩
印度寺庙	印度寺庙 🛕
印度油灯	印度油灯 🪔
英镑	英镑 💷
英格兰	英格兰 🏴󠁧󠁢󠁥󠁮󠁧󠁿
英国	英国 🇬🇧
英式橄榄球	英式橄榄球 🏉
英属维尔京群岛	英属维尔京群岛 🇻🇬
英属印度洋领地	英属印度洋领地 🇮🇴
樱花	樱花 🌸
樱桃	樱桃 🍒
鹦鹉	鹦鹉 🦜
鹰	鹰 🦅
迎面驶来的出租车	迎面驶来的出租车 🚖
迎面驶来的公交车	迎面驶来的公交车 🚍
迎面驶来的警车	迎面驶来的警车 🚔
迎面驶来的汽车	迎面驶来的汽车 🚘
盈凸月	盈凸月 🌔
影片帧	影片帧 🎞️
硬币	硬币 🪙
悠悠球	悠悠球 🪀
邮号	邮号 📯
邮局	邮局 🏤
邮筒	邮筒 📮
犹太教堂	犹太教堂 🕍
油泵	油泵 ⛽
游乐场滑梯	游乐场滑梯 🛝
游戏操控杆	游戏操控杆 🕹️
游戏手柄	游戏手柄 🎮
游泳	游泳 🏊
游泳的男人	游泳的男人 🏊‍♂️
游泳的女人	游泳的女人 🏊‍♀️
有待收信件	有待收信件 📫
有蛋的巢	有蛋的巢 🪺
有轨电车	有轨电车 🚋
有胡子的人	有胡子的人 🧔
有环行星	有环行星 🪐
有络腮胡子的男人	有络腮胡子的男人 🧔‍♂️
有络腮胡子的女人	有络腮胡子的女人 🧔‍♀️
有雾	有雾 🌁
有新信件	有新信件 📬
右上箭头	右上箭头 ↗️
右上弯箭头	右上弯箭头 ⤴️
右下箭头	右下箭头 ↘️
右下弯箭头	右下弯箭头 ⤵️
右斜的放大镜	右斜的放大镜 🔎
右转弯箭头	右转弯箭头 ↩️
幼苗	幼苗 🌱
鱼	鱼 🐟
鱼板	鱼板 🍥
宇航员	宇航员 🧑‍🚀
羽毛	羽毛 🪶
羽毛球	羽毛球 🏸
雨伞	雨伞 ☔
玉米	玉米 🌽
郁金香	郁金香 🌷
郁闷	郁闷 🫤
浴缸	浴缸 🛁
原子符号	原子符号 ⚛️
圆圈包围的m	圆圈包围的m Ⓜ️
圆筒冰激凌	圆筒冰激凌 🍦
圆图钉	圆图钉 📍
圆形花饰	圆形花饰 🏵️
约旦	约旦 🇯🇴
月饼	月饼 🥮
越南	越南 🇻🇳
晕	晕 😵‍💫
晕头转向	晕头转向 😵
云	云 ☁️
孕妇	孕妇 🤰
运动背心	运动背心 🎽
运动型多用途车	运动型多用途车 🚙
暂停按钮	暂停按钮 ⏸️
赞比亚	赞比亚 🇿🇲
皂	皂 🧼
泽西岛	泽西岛 🇯🇪
眨眼	眨眼 😉
乍得	乍得 🇹🇩
炸弹	炸弹 💣
炸豆丸子	炸豆丸子 🧆
站立者	站立者 🧍
张开双手	张开双手 👐
章鱼	章鱼 🐙
蟑螂	蟑螂 🪳
长翅膀的钱	长翅膀的钱 💸
长笛	长笛 🪈
长鼓	长鼓 🪘
长颈鹿	长颈鹿 🦒
掌心向上的手	掌心向上的手 🫴
掌心向上托起	掌心向上托起 🤲
掌心向下的手	掌心向下的手 🫳
帐篷	帐篷 ⛺
账本	账本 📒
爪印	爪印 🐾
折扇	折扇 🪭
侦探	侦探 🕵️
珍珠奶茶	珍珠奶茶 🧋
振动模式	振动模式 📳
震惊	震惊 😲
睁眼捂嘴	睁眼捂嘴 🫢
蒸房里的人	蒸房里的人 🧖
蒸馏器	蒸馏器 ⚗️
蒸汽房间里的男人	蒸汽房间里的男人 🧖‍♂️
蒸汽房间里的女人	蒸汽房间里的女人 🧖‍♀️
蒸汽火车	蒸汽火车 🚂
正面朝向的小鸡	正面朝向的小鸡 🐥
正中靶心的飞镖	正中靶心的飞镖 🎯
芝士	芝士 🧀
蜘蛛	蜘蛛 🕷️
蜘蛛网	蜘蛛网 🕸️
直布罗陀	直布罗陀 🇬🇮
直尺	直尺 📏
直升机	直升机 🚁
纸杯蛋糕	纸杯蛋糕 🧁
指南针	指南针 🧭
指向观察者的食指	指向观察者的食指 🫵
致敬	致敬 🫡
智利	智利 🇨🇱
置顶	置顶 🔝
中等音量的扬声器	中等音量的扬声器 🔉
中非共和国	中非共和国 🇨🇫
中国	中国 🇨🇳
中国澳门特别行政区	中国澳门特别行政区 🇲🇴
中国香港特别行政区	中国香港特别行政区 🇭🇰
终点旗	终点旗 🏁
重复按钮	重复按钮 🔁
重复一次按钮	重复一次按钮 🔂
皱眉	皱眉 🙍
皱眉的男人	皱眉的男人 🙍‍♂️
猪	猪 🐖
猪鼻子	猪鼻子 🐽
猪头	猪头 🐷
烛台	烛台 🕎
拄盲杖的男人	拄盲杖的男人 👨‍🦯
拄盲杖的女人	拄盲杖的女人 👩‍🦯
拄盲杖的人	拄盲杖的人 🧑‍🦯
注册	注册 ®️
注射器	注射器 💉
砖	砖 🧱
装有食物的浅底锅	装有食物的浅底锅 🥘
龇牙咧嘴	龇牙咧嘴 😬
子弹头高速列车	子弹头高速列车 🚅
紫色方块	紫色方块 🟪
紫色圆	紫色圆 🟣
紫心	紫心 💜
自拍	自拍 🤳
自行车	自行车 🚲
自由女神像	自由女神像 🗽
宗教场所	宗教场所 🛐
棕榈树	棕榈树 🌴
棕色方块	棕色方块 🟫
棕色蘑菇	棕色蘑菇 🍄‍🟫
棕色圆	棕色圆 🟤
棕心	棕心 🤎
纵向的红绿灯	纵向的红绿灯 🚦
足球	足球 ⚽
嘴	嘴 👄
嘴上有符号的脸	嘴上有符号的脸 🤬
左上箭头	左上箭头 ↖️
左下箭头	左下箭头 ↙️
左斜的放大镜	左斜的放大镜 🔍
左右箭头	左右箭头 ↔️
左转弯箭头	左转弯箭头 ↪️
坐电动轮椅的男人	坐电动轮椅的男人 👨‍🦼
坐电动轮椅的女人	坐电动轮椅的女人 👩‍🦼
坐电动轮椅的人	坐电动轮椅的人 🧑‍🦼
坐手动轮椅的男人	坐手动轮椅的男人 👨‍🦽
坐手动轮椅的女人	坐手动轮椅的女人 👩‍🦽
坐手动轮椅的人	坐手动轮椅的人 🧑‍🦽
座位	座位 💺
座钟	座钟 🕰️
做成心形的双手	做成心形的双手 🫶